NO img/walls/blue.xpm
SO img/walls/brick.xpm
WE img/walls/grey.xpm
EA img/walls/wood.xpm
F 80,0,0
C 0,255,255

        1111111111111111111111111
        1000000000110000000000001
        1011000001110000000000001
        1001000000000000000000001
111111111011000001110000000000001
100000000011000001110111111111111
11110111111111111100000010001
11110111111111 11101010010001
11000000110101111100000010001
10000000000000000000000010001
1000W000000000001101010010001
11000001110101011111011010011
11110111 1110101 101111010001
11111111 1111111 111111111111
