                  SO             img/walls/grey.xpm
 WE     img/walls/brick.xpm     
        EA     img/walls/wood.xpm               
 F   	    img/ground.xpm
                        C img/sky.xpm
NO img/walls/blue.xpm



                                     
     
        1111111111111111111111111
        1000000000110000000000001
        1011000001110000000000001
        10010000000D0000000000001
11111111101100000111000W000000001
10000000001100000111D1D1111111111
11110111111111011100000010001
11110111111111011101010010001
11000000110101011100000010001
10000000000000001100000000001
11100000000000000011010100001
1000001111101011111011011D111
11110111 1110101 101111010001
11111111 1111111 111111111111
 
  11111
  10001
  11111
