NO img/walls/blue.xpm
                  SO             img/walls/grey.xpm 
 WE     img/walls/brick.xpm     
        EA     img/walls/wood.xpm               
 F   	    img/ground.xpm
                        C img/sky.xpm





        1111111111111111111111111
        1000000000110000000000001
        1011000001110000000000001
        100100000000L000000000001
111111111011000001110000000000001
10000000001100000111D111111111111
11110111111111011100000010001
11110111111111011101010010001
11000000110101011100000L10001
10000E00000000001100000010001
11100000000000000011010100101
1000001111101011111011111D111
11110111 1110101 101111010X01
11111111 1111111 111111111111
